14 12
############
#..........#
##.#######.#
##########.#
#.......##.#
#.#####.##.#
#.#####.##.#
#.##1##.##.#
#.##2##.##.#
#.##....##.#
#.########.#
#.########.#
#..........#
############