7 5
#####
#..2#
#.###
#..##
#.###
#..1#
#####