13 15
###############
#r#.....#.....#
#.#.###.#####.#
#...#b#.#.....#
#.###.#.#.###.#
#.#.#...#.#B#.#
#.#.#####.#.#.#
#.#.....#.#...#
#.###.#.#.#.###
#.#...#...#...#
#.#.#########.#
#...#........R#
###############