6 5
#####
##.B#
##.##
#.r##
##2##
#####