9 10
##########
#####.B..#
#..##.#..#
#.###.#..#
#.###.##.#
#.###....#
#.3#####.#
#####b...#
##########