################
#..............#
#.#####..#####.#
#.#......#.....#
#.#.###..#.###.#
#.#..2#..#..1#.#
#.#####..#####.#
#..............#
################