7 7
#######
#.....#
#B#.#R#
###.###
#r#.#b#
#.....#
#######