5 7
#######
###.###
#rb.BR#
###.###
#######