7 6
######
###R##
#r##.#
####.#
#b##.#
###B##
######