9 13
#############
#...........#
#.####.####.#
#.#....#....#
#.#.##.#.##.#
#.#.2#.#.1#.#
#.####.####.#
#...........#
#############