13 15
###############
#.....#...#...#
#.#.###.#.#.#.#
#.#..R#.#b#.#.#
#.#####.###.#.#
#.#...#.....#.#
#.###.###.###.#
#.........#.#.#
###.###.###.#.#
#...#B#.#r..#.#
#.###.#####.#.#
#.........#...#
###############