9 7
#######
#B###R#
#..#..#
##...##
###.###
##...##
#..#..#
#r###b#
#######